memory_initialization_radix=16;
memory_initialization_vector=
0C20A79C,
0820BECA,
0C40A01C,
0840BC0F,
0C60A4FD,
0860BECA,
0C80CF81,
0880BC0F,
0CA0197A,
08A0BF7D,
0CC0619D,
08C0BC0F,
0CE0EB07,
08E0BF77,
0D00D584,
0900BDB8,
0D20B852,
0920BF7E,
0D4079E6,
09403D90,
0D60460B,
0960BF7D,
0D80F759,
0980BB8F,
0DA065BF,
09A0BF7E,
0DC00D5F,
09C03D10,
0DE018D2,
09E0BF7D,
0E00DE9A,
0A00BC0F,
0E20EA60,
0A20BF77,
0E40E4B8,
0A40BDB8,
0E60B852,
0A60BF7E,
0E806A2B,
0A803D90,
90200000,
90400000,
90600000,
90800000,
90A00000,
90C00000,
90E00000,
91000000,
91200000,
91400000,
91600000,
91800000,
91A00000,
91C00000,
91E00000,
92000000,
92200000,
92400000,
92600000,
92800000,
94200000,
94400000,
94600000,
94800000,
94A00000,
94C00000,
94E00000,
95000000,
95200000,
95400000,
95600000,
95800000,
95A00000,
95C00000,
95E00000,
96000000,
96200000,
96400000,
96600000,
96800000,
00000000;
