memory_initialization_radix=16;
memory_initialization_vector=
0C20FFFF,
082003FF,
0D600000,
0D400000,
0C400000,
08400800,
0C600001,
08600800,
0C800002,
0CA00001,
0DC000FF,
0CE00069,
0CC0B000,
08C00004,
51030000,
10082800,
409FFFFD,
54E20000,
51030000,
10082000,
409FFFFD,
51820000,
0DE00004,
11AC7000,
020B5000,
55B00000,
258C0008,
014A2800,
04C62800,
05EF2800,
401FFFF8,
14060000,
401FFFF1,
30000000,
0C400000,
0C600001,
0C800004,
08800800,
0CA00005,
08A00800,
54440000,
54650000,
439FFFFF,
0D600000,
09600020,
0D400000,
0C400000,
08400800,
0C600001,
08600800,
0C800002,
0CA00001,
0DC000FF,
0CE00070,
0CC0B000,
08C00004,
51030000,
10082800,
409FFFFD,
54E20000,
51030000,
10082000,
409FFFFD,
51820000,
0DE00004,
11AC7000,
020B5000,
55B00000,
258C0008,
014A2800,
04C62800,
05EF2800,
401FFFF8,
14060000,
401FFFF1,
00000000;
